1
XXXXXXXXXXXXXXXXXXXXXXXXXXXXXXXXXXXXXXX
X------------------X--------X---------X
X--------X--M------XXXXXXX--X---------X
X------------------X-->---------------X
X--M-------X---------XXXXXXXXX--------X
X-------<->--------X------------------X
X-----------M------X------------------X
XXXXXXXXXXXXXXXXXXXXXXXXXXXXXXXXXXXXXXX
#
#
#
2
XXXXXXXXXXX
X-M--X---MX
X-<--X--->X
X----X----X
X----X----X
X-----M---X
XXXXXXXXXXX
#
#
#
3
XXXXXXXXXXXXXXXXXXX
X-M<-->-XXX----M--X
XXXXXX-------XXXXXX
X-------XXX-------X
XXXXXX-------XXXXXX
X-------XXX----->-X
XXXXXXM------XXXXXX
X-------XXX-------X
XXXXXX-------XXXXXX
X-------XXX------MX
XXXXXX-------XXXXXX
XXXXXXXXXXXXXXXXXXX
#
#
#
4
XXXXXXXX
X<--M->X
XXXXXXXX
#


